10
20
####################
#..................#
#..................#
#..................#
#P................E#
#..................#
#..................#
#..................#
#..................#
####################